Ábalos Meco, José Luis	Socialista	Valencia
Abascal Conde, Santiago	Vox	Madrid
Aceves Galindo, José Luis	Socialista	Segovia
Agirretxea Urresti, Joseba Andoni	Vasco (EAJ-PNV)	Guipúzcoa
Aizcorbe Torra, Juan José	Vox	Barcelona
Aizpurua Arzallus, Mertxe	EH Bildu	Guipúzcoa
Alcaraz Martos, Francisco José	Vox	Jaén
Alfonso Cendón, Javier	Socialista	León
Almodóbar Barceló, Agustín	Popular	Alicante
Alonso Pérez, José Ángel	Popular	Valladolid
Alonso Suárez, María Olga	Socialista	Pontevedra
Alonso-Cuevillas i Sayrol, Jaume	Mixto	Barcelona
Álvarez de Toledo Peralta-Ramos, Cayetana	Popular	Barcelona
Álvarez Fanjul, Beatriz	Popular	Vizcaya
Andrés Añón, Carmen	Socialista	Barcelona
Andrés Barea, Josefa	Socialista	Valencia
Angulo Romero, María Teresa	Popular	Badajoz
Antón Cacho, Javier	Socialista	Soria
Aragonés Mendiguchía, Carlos	Popular	Madrid
Aranda Vargas, Francisco	Socialista	Barcelona
Arangüena Fernández, Pablo	Socialista	A Coruña
Arrimadas García, Inés	Ciudadanos	Barcelona
Asarta Cuevas, Alberto	Vox	Castellón
Asens Llodrà, Jaume	Podemos	Barcelona
Bal Francés, Edmundo	Ciudadanos	Madrid
Baldoví Roda, Joan	Mixto	Valencia
Barandiaran Benito, Íñigo	Vasco (EAJ-PNV)	Guipúzcoa
Bas Corugeira, Javier	Popular	Pontevedra
Bassa Coll, Montserrat	Republicano	Gerona
Batet Lamaña, Meritxell	Socialista	Barcelona
Bel Accensi, Ferran	Mixto	Tarragona
Belarra Urteaga, Ione	Podemos	Navarra
Beltrán Villalba, Ana María	Popular	Madrid
Berja Vega, Laura	Socialista	Jaén
Bermúdez de Castro Fernández, José Antonio	Popular	Salamanca
Betoret Coll, Vicente	Popular	Valencia
Blanquer Alcaraz, Patricia	Socialista	Alicante
Boadella Esteve, Genís	Mixto	Barcelona
Borràs Castanyer, Laura	Mixto	Barcelona
Borrás Pabón, Mireia	Vox	Madrid
Borrego Cortés, Isabel María	Popular	Murcia
Botella Gómez, Ana María	Socialista	Valencia
Botran Pahissa, Albert	Mixto	Barcelona
Bravo Barco, Eva	Socialista	Cádiz
Bueno Campanario, Eva Patricia	Socialista	Sevilla
Caballero Gutiérrez, Helena	Socialista	Valladolid
Cabezón Casas, Tomás	Popular	Soria
Callejas Cano, Juan Antonio	Popular	Ciudad Real
Calvo Liste, Pablo Juan	Vox	León
Calvo Poyato, Carmen	Socialista	Madrid
Cambronero Piqueras, Pablo	Ciudadanos	Sevilla
Campo Moreno, Juan Carlos	Socialista	Cádiz
Cañadell Salvia, Concep	Mixto	Lleida
Canales Duque, Mariana de Gracia	Socialista	Cuenca
Cancela Rodríguez, Pilar	Socialista	A Coruña
Cañizares Pacheco, Inés María	Vox	Toledo
Cantera de Castro, Zaida	Socialista	Madrid
Capdevila i Esteve, Joan	Republicano	Barcelona
Carazo Hermoso, Eduardo	Popular	Valladolid
Carcedo Roces, María Luisa	Socialista	Asturias
Carrillo de los Reyes, Beatriz Micaela	Socialista	Sevilla
Carvalho Dantas, María	Republicano	Barcelona
Casado Blanco, Pablo	Popular	Madrid
Casares Hontañón, Pedro	Socialista	Cantabria
Casero Ávila, Alberto	Popular	Cáceres
Castellón Rubio, Miguel Ángel	Popular	Almería
Castillo López, Elena	Popular	Cantabria
Celaá Diéguez, Isabel	Socialista	Álava
Cerdán León, Santos	Socialista	Navarra
Cerqueiro González, Javier	Socialista	Lugo
Chamorro Delmo, Ricardo	Vox	Ciudad Real
Clavell López, Óscar	Popular	Castellón
Contreras Peláez, Francisco José	Vox	Sevilla
Corredor Sierra, María Beatriz	Socialista	Madrid
Cortés Carballo, Mario	Popular	Málaga
Cortés Gómez, Ismael	Podemos	Tarragona
Crespín Rubio, Rafaela	Socialista	Córdoba
Cruz-Guzmán García, María Soledad	Popular	Sevilla
Cuatrecasas Asua, Juan	Socialista	La Rioja
De las Heras Fernández, Patricia	Vox	Islas Baleares
De Luna Tobarra, Llanos	Popular	Barcelona
De Meer Méndez, Rocío	Vox	Almería
De Quinto Romero, Marcos	Ciudadanos	Madrid
Del Valle Rodríguez, Emilio Jesús	Vox	Cantabria
Delgado Arce, Celso Luis	Popular	Orense
Delgado García, Dolores	Socialista	Madrid
Díaz Gómez, Guillermo	Ciudadanos	Málaga
Díaz Pérez, Yolanda	Podemos	Pontevedra
Diouf Dioh, Luc Andre	Socialista	Las Palmas
Duque Duque, Pedro	Socialista	Alicante
Durán Peralta, José Carlos	Socialista	Málaga
Echániz Salgado, José Ignacio	Popular	Guadalajara
Echenique Robba, Pablo	Podemos	Zaragoza
Elizo Serrano, María Gloria	Podemos	Madrid
Elorza González, Odón	Socialista	Guipúzcoa
Eritja Ciuró, Francesc Xavier	Republicano	Lleida
Errejón Galván, Íñigo	Mixto	Madrid
España Reina, Carolina	Popular	Málaga
Espejo-Saavedra Conesa, José María	Ciudadanos	Barcelona
Espinosa de los Monteros de Simón, Iván	Vox	Madrid
Esteban Bravo, Aitor	Vasco (EAJ-PNV)	Vizcaya
Esteban Calonge, Cristina Alicia	Vox	Valencia
Fagúndez Campo, Antidio	Socialista	Zamora
Faneca López, María Luisa	Socialista	Huelva
Fernández Benéitez, Andrea	Socialista	León
Fernández Casero, Ana Belén	Socialista	Cáceres
Fernández Castañón, Sofía	Podemos	Asturias
Fernández Hernández, Pedro	Vox	Zaragoza
Fernández Ríos, Tomás	Vox	Huelva
Fernández-Lomana Gutiérrez, Rafael	Vox	Albacete
Fernández-Roca Suárez, Carlos Hugo	Vox	Almería
Ferrer Tesoro, Sonia	Socialista	Almería
Figaredo Álvarez-Sala, José María	Vox	Asturias
Franco Carmona, Isabel	Podemos	Sevilla
Franco Pardo, José Manuel	Socialista	Madrid
Gago Bugarín, Diego	Popular	Pontevedra
Gamarra Ruiz-Clavijo, Concepción	Popular	La Rioja
Gamazo Micó, Óscar	Popular	Valencia
Garcés Sanagustín, Mario	Popular	Huesca
García Adanero, Carlos	Mixto	Navarra
García Chavarría, María Montserrat	Socialista	A Coruña
García Díez, Joaquín María	Popular	Lugo
García Egea, Teodoro	Popular	Murcia
García Gómez, Valentín	Socialista	Badajoz
García López, Maribel	Socialista	Badajoz
García Morís, Roberto	Socialista	Asturias
García Puig, María del Mar	Podemos	Barcelona
García Rodríguez, Alicia	Popular	Ávila
García Tejerina, Isabel	Popular	Valladolid
García-Pelayo Jurado, María José	Popular	Cádiz
Garrido Gutiérrez, Pilar	Podemos	Guipúzcoa
Garriga Vaz de Concicao, Ignacio	Vox	Barcelona
Garzón Espinosa, Alberto	Podemos	Málaga
Gázquez Collado, Paloma	Popular	Asturias
Gestoso de Miguel, Luis	Vox	Murcia
Gil Lázaro, Ignacio	Vox	Valencia
Giménez Giménez, Sara	Ciudadanos	Madrid
Gómez Hernández, Héctor	Socialista	Tenerife
Gómez-Reino Varela, Antonio	Podemos	A Coruña
González Caballero, Miguel Ángel	Socialista	Ciudad Real
González Coello de Portugal, Víctor	Vox	Salamanca
González Guinda, María del Carmen	Popular	León
González Pérez, Ariagona	Socialista	Las Palmas
González Ramos, Manuel Gabriel	Socialista	Albacete
González Terol, Antonio	Popular	Madrid
González Vázquez, Marta	Popular	A Coruña
Gorospe Elezcano, Josune	Vasco (EAJ-PNV)	Vizcaya
Grande-Marlaska Gómez, Fernando	Socialista	Cádiz
Granollers Cunillera, Inés	Republicano	Lleida
Guaita Esteruelas, Sandra	Socialista	Tarragona
Guijarro Ceballos, María	Socialista	Vizcaya
Guijarro García, Txema	Podemos	Alicante
Guinart Moreno, Lídia	Socialista	Barcelona
Guirao Cabrera, José	Socialista	Almería
Guitarte Gimeno, Tomás	Mixto	Teruel
Gutiérrez Díaz de Otazu, Fernando Adolfo	Popular	Melilla
Gutiérrez Prieto, Sergio	Socialista	Toledo
Hernanz Costa, Sofía	Socialista	Islas Baleares
Herrero Bono, José Alberto	Popular	Teruel
Hispán Iglesias de Ussel, Pablo	Popular	Granada
Honrubia Hurtado, Pedro Antonio	Podemos	Granada
Hoyo Juliá, Belén	Popular	Valencia
Iglesias Turrión, Pablo	Podemos	Madrid
Illamola Dausà, Mariona	Mixto	Gerona
Illueca Ballester, Héctor	Podemos	Valencia
Iñarritu García, Jon	EH Bildu	Guipúzcoa
Izquierdo Roncero, José Javier	Socialista	Valladolid
Jerez Juan, Miguel Ángel	Popular	Islas Baleares
Jiménez Linuesa, Beatriz	Popular	Cuenca
Jiménez Revuelta, Rodrigo	Vox	Segovia
Jiménez-Becerril Barrio, María Teresa	Popular	Sevilla
Jover Díaz, Antonia	Podemos	Islas Baleares
Lamuà Estañol, Marc	Socialista	Gerona
Lastra Fernández, Adriana	Socialista	Asturias
Ledesma Martín, Sebastián Jesús	Popular	Santa Cruz de Tenerife
Legarda Uriarte, Mikel	Vasco (EAJ-PNV)	Álava
Lima Cid, Fuensanta	Socialista	Málaga
López Álvarez, María Teresa	Vox	Ceuta
López Álvarez, Patxi	Socialista	Vizcaya
López Cano, Ignacio	Socialista	Málaga
López de Uralde Garmendia, Juan Antonio	Podemos	Álava
López Domínguez, Laura	Podemos	Gerona
López Maraver, Ángel	Vox	Guadalajara
López Zamora, Cristina	Socialista	Ciudad Real
Lorite Lorite, Andrés	Popular	Córdoba
Maestro Moliner, Roser	Podemos	Valencia
Máñez Rodríguez, Elena	Socialista	Las Palmas
Manso Olivar, Rubén Silvano	Vox	Málaga
Marcos Domínguez, Pilar	Popular	Madrid
Marcos Ortega, Milagros	Popular	Palencia
Margall Sastre, Joan	Republicano	Gerona
Mari Klose, Pau	Socialista	Zaragoza
Mariscal Anaya, Guillermo	Popular	Las Palmas
Mariscal Zabala, Manuel	Vox	Toledo
Maroto Illera, Reyes	Socialista	Madrid
Márquez Guerrero, María	Podemos	Sevilla
Marra Domínguez, María Ángeles	Socialista	Pontevedra
Marrodán Funes, María	Socialista	La Rioja
Martín Llaguno, Marta	Ciudadanos	Alicante
Martínez Ferro, María Valentina	Popular	A Coruña
Martínez Granados, María Carmen	Ciudadanos	Cádiz
Martínez Oblanca, Isidro Manuel	Mixto	Asturias
Martínez Seijo, María Luz	Socialista	Palencia
Matarí Sáez, Juan José	Popular	Almería
Mateu Istúriz, Jaime Miguel	Popular	Burgos
Matute García de Jalón, Oskar	EH Bildu	Vizcaya
Mayoral Perales, Rafael	Podemos	Madrid
Mazón Ramos, José María Ángel	Mixto	Cantabria
Meijón Couselo, Guillermo Antonio	Socialista	Pontevedra
Mena Arca, Joan	Podemos	Barcelona
Méndez Monasterio, Lourdes	Vox	Murcia
Merino Martínez, Javier	Popular	La Rioja
Mestre Barea, Manuel	Vox	Alicante
Mínguez García, Montse	Socialista	Lleida
Miquel i Valentí, Sergi	Mixto	Gerona
Moneo Díez, María Sandra	Popular	Burgos
Montero Cuadrado, María Jesús	Socialista	Sevilla
Montero Gil, Irene María	Podemos	Madrid
Montesinos Aguayo, Pablo	Popular	Málaga
Montesinos de Miguel, Macarena	Popular	Alicante
Montilla Martos, José Antonio	Socialista	Granada
Moraleja Gómez, Tristana María	Popular	A Coruña
Moro Almaraz, María Jesús	Popular	Salamanca
Movellán Lombilla, Diego	Popular	Cantabria
Muñoz Dalda, Lucía	Podemos	Islas Baleares
Muñoz Vidal, María	Ciudadanos	Valencia
Narváez Bandera, María Dolores	Socialista	Málaga
Nasarre Oliva, Begoña	Socialista	Huesca
Navarro Lacoba, Carmen	Popular	Albacete
Navarro López, Pedro	Popular	Zaragoza
Nevado del Campo, María Magdalena	Vox	Cáceres
Nogueras i Camero, Míriam	Mixto	Barcelona
Nuet Pujals, Joan Josep	Republicano	Barcelona
Olano Vela, Jaime Eduardo de	Popular	Lugo
Olona Choclán, Macarena	Vox	Granada
Oramas González-Moro, Ana María	Mixto	Tenerife
Ortega Otero, Marina	Socialista	Orense
Ortega Smith-Molina, Francisco Javier	Vox	Madrid
Ortiz Galván, José	Popular	Cádiz
Padilla Ruiz, Esther	Socialista	Toledo
Paniagua Núñez, Miguel Ángel	Popular	Palencia
Pastor Julián, Ana María	Popular	Pontevedra
Pedreño Molina, Juan Luis	Popular	Murcia
Peña Camarero, Esther	Socialista	Burgos
Perea i Conillas, María Mercè	Socialista	Barcelona
Pérez Abellás, Adolfo	Socialista	Orense
Pérez Díaz, María Auxiliadora	Popular	Las Palmas
Píriz Maya, Víctor Valentín	Popular	Badajoz
Pisarello Prados, Gerardo	Podemos	Barcelona
Planas Puchades, Luis	Socialista	Córdoba
Polo Llavata, Francisco	Socialista	Barcelona
Pons Sampietro, Pere Joan	Socialista	Islas Baleares
Postigo Quintana, Jesús	Popular	Segovia
Pozueta Fernández, Isabel	EH Bildu	Navarra
Prieto Nieto, Ana	Socialista	Lugo
Prohens Rigo, Margarita	Popular	Islas Baleares
Pujol i Farré, Norma	Republicano	Tarragona
Quevedo Iturbe, Pedro	Mixto	Las Palmas
Ramallo Vázquez, María Pilar	Popular	Pontevedra
Ramírez Carner, Arnau	Socialista	Barcelona
Ramírez del Río, José	Vox	Córdoba
Ramón Utrabo, Elvira	Socialista	Granada
Ramos Esteban, César Joaquín	Socialista	Cáceres
Ramos Rodríguez, José Luis	Socialista	Huelva
Raya Rodríguez, María Tamara	Socialista	Tenerife
Redondo Calvillo, María de la O	Popular	Córdoba
Rego Candamil, Néstor	Mixto	A Coruña
Renau Martínez, Germán	Socialista	Castellón
Requejo Novoa, Pedro Jesús	Vox	Zamora
Requena Ruiz, Juan Diego	Popular	Jaén
Ribera Rodríguez, Teresa	Socialista	Madrid
Riolobos Regadera, Carmen	Popular	Toledo
Robles Fernández, Margarita	Socialista	Ávila
Robles López, Joaquín	Vox	Murcia
Rodríguez Almeida, Andrés Alberto	Vox	Las Palmas
Rodríguez Gómez, María del Pilar	Socialista	Huelva
Rodríguez Gómez de Celis, Alfonso	Socialista	Sevilla
Rodríguez Herrer, María Elvira	Popular	Madrid
Rodríguez Rodríguez, Alberto	Podemos	Tenerife
Rodríguez Salas, José Antonio	Socialista	Granada
Rojas García, Carlos	Popular	Granada
Romero Hernández, Carmelo	Popular	Huelva
Romero Sánchez, Rosa María	Popular	Ciudad Real
Romero Vilches, María de los Reyes	Vox	Sevilla
Ros Martínez, Susana	Socialista	Castellón
Rosell Aguilar, María Victoria	Podemos	Las Palmas
Rosety Fernández de Castro, Agustín	Vox	Cádiz
Rosique i Saltor, Marta	Republicano	Barcelona
Rueda Perelló, Patricia	Vox	Málaga
Rufián Romero, Gabriel	Republicano	Barcelona
Ruiz de Pinedo Undiano, Iñaki	EH Bildu	Álava
Ruiz i Carbonell, Joan	Socialista	Tarragona
Ruiz Navarro, Eduardo Luis	Vox	Alicante
Ruiz Solás, María de la Cabeza	Vox	Madrid
Saavedra Muñoz, Marisa	Podemos	Castellón
Sabanés Nadal, Inés	Mixto	Madrid
Sáez Alonso-Muñumer, Pablo	Vox	Valladolid
Sagastizabal Unzetabarrenetxea, Idoia	Vasco (EAJ-PNV)	Vizcaya
Sahuquillo García, Luis Carlos	Socialista	Cuenca
Salazar Rodríguez, Francisco José	Socialista	Sevilla
Salvá Verd, Antonio	Vox	Islas Baleares
Salvador i Duch, Jordi	Republicano	Tarragona
Sánchez del Real, Víctor Manuel	Vox	Badajoz
Sánchez Escobar, Mariano	Socialista	Badajoz
Sánchez García, José María	Vox	Alicante
Sánchez Jódar, Marisol	Socialista	Murcia
Sánchez Pérez, César	Popular	Alicante
Sánchez Pérez-Castejón, Pedro	Socialista	Madrid
Sánchez Serna, Javier	Podemos	Murcia
Sancho Guardia, Alfredo	Socialista	Huesca
Sancho Íñiguez, Herminio Rufino	Socialista	Teruel
Santamaría Ruiz, Luis	Popular	Valencia
Santiago Romero, Enrique Fernando	Podemos	Madrid
Sarrià Morell, Vicent Manuel	Socialista	Valencia
Saura García, Pedro	Socialista	Murcia
Sayas López, Sergio	Mixto	Navarra
Serrada Pariente, David	Socialista	Salamanca
Serrano Martínez, Juan Francisco	Socialista	Jaén
Seva Ruiz, Yolanda	Socialista	Alicante
Sicilia Alférez, Felipe Jesús	Socialista	Jaén
Simancas Simancas, Rafael	Socialista	Madrid
Soler Mur, Alejandro	Socialista	Alicante
Soto Burillo, Juan Luis	Socialista	Murcia
Steegmann Olmedillas, Juan Luis	Vox	Madrid
Suárez Illana, Adolfo	Popular	Madrid
Suárez Lamata, Eloy	Popular	Zaragoza
Sumelzo Jordán, Susana	Socialista	Zaragoza
Telechea i Lozano, Carolina	Republicano	Barcelona
Tirado Ochoa, Vicente	Popular	Toledo
Toscano de Balbín, Carla	Vox	Madrid
Trías Gil, Georgina	Vox	Ávila
Uriarte Bengoechea, Edurne	Popular	Madrid
Uriarte Torrealday, Roberto	Podemos	Vizcaya
Utrilla Cano, Julio	Vox	Valencia
Valerio Cordero, Magdalena	Socialista	Guadalajara
Vallugera Balañà, Pilar	Republicano	Barcelona
Vázquez Blanco, Ana Belén	Popular	Orense
Vega Arias, Rubén Darío	Vox	Santa Cruz de Tenerife
Vehí Cantenys, Mireia	Mixto	Barcelona
Velarde Gómez, Martina	Podemos	Córdoba
Velasco Morillo, Elvira	Popular	Zamora
Vera Ruíz-Herrera, Noelia	Podemos	Cádiz
Vicente Viondi, Daniel	Socialista	Madrid
Vidal Sáez, Aina	Podemos	Barcelona
Vilches Ruiz, María Luisa	Socialista	Albacete
Villagrasa Quero, Noemí	Socialista	Zaragoza
Zamarrón Moreno, Agustín	Socialista	Burgos
Zambrano García-Raez, Carlos José	Vox	Santa Cruz de Tenerife
Zaragoza Alonso, José	Socialista	Barcelona
Zurita Expósito, Ana María	Popular	Tenerife
